111111111111111111111111111111111
1E0000X000000X0C00000C00000X00001
101001001110101000100100000001011
1P0000000C00C0000000X00000X0000C1
111111111111111111111111111111111