1111111111
1010P11101
1011C00001
111EC000C1
1010010011
10100C1001
1000001001
1010110101
110001C0C1
1111111111